12222222222222222*000<:-00000000000000000000000000000000000
455555555555555555*000<:-0000000000000000000000000000000000
4555555555555555555*000<:-000000000000000000000000000000000
78888888888888888555*000<:-00000000000000000000000000000000
000000000000000007555*000</0~-00000000000000000000000000000
0000000000000000007555*00000+;||||-000000000000000000000000
00000000000000000007555*0000+;::::;000000000000000000000000
000000000000000000007555*000+;::::;000000000000000000000000
0000000000000000000007555*00+;::::;000000000000000000000000
00000000^00000000000007555*0+;::::;000000000000000000000000
00000000^000000000000007555222222222*0000000000000000000000
00000000^0000000000000007555555555555*000000000000000000000
00000000^00000000000000007555555555555*00000000000000000000
00000000^00!@@@@@#000000007888888888555*0000000000000000000
00000000^00$%%%%%^0000000000000000007555*000000000000000000
00000000^00$%%%%%^00000000000000000007555*00000000000000000
00000000^00$%%%%%^000000000000000000007555*0000000000000000
00000000^00$%%%%^000000000000000000000078890000000000000000
00000000^00000000000000000000~|||||-000000000&0000000000000
00000000^0000000000000000000~:::::/000000000&50000000000000
00000000^000000000000000000~::::>/000000000&590000000000000
00000000^0000000000000000~:::::/0000000000&5900000000000000
00000000^00000000000000~::::::/0000000000079000000000000000
00000000^0000~|-0000000>>>>>>/0&222222222300000000000000000
00000000^0000+:;00000000000000&!@@@@#5555600000000000000000
00000000^0000+:;0000000000000&5$%%%^55555600000000000000000
00000000^12222222222222222222555555555888900000000000000000
00000000^45555555555555555555655555559000000000000000000000
00000000^45555555555555!@@#5565555559!@@@@@@@@@@@@@@@@@@@@#
00000000^455555555555555%%5556555559$%%%%%%%%%%%%%%%%%%%%%^
00000000^788888888888888%%888888889$%%%%%%%%%%%%%%%%%%%%%%^
0000000000000000000000000000000000$%%%%%%%%%%%%%%%%%%%%%%%^